NNNNNNNNNN
NXX000XXXN
NXX0F0XXXN
NXX0B0000N
N0001PBF0N
N0F1BB000N
N000010XXN
NXXX0F0XXN
NXXX000XXN
NNNNNNNNNN