NNNNNNNNNN
NXX000XXXN
NXX0F0XXXN
NXX010000N
N000B1BF0N
N0F1BP000N
N0000B0XXN
NXXX0F0XXN
NXXX000XXN
NNNNNNNNNN