XX000XXX
XX0F0XXX
XX010000
000B1BF0
0F1BP000
0000B0XX
XXX0F0XX
XXX000XX
