XX000XXXX
XX0F0XXXX
XX010000X
000B1BF0X
0F1BP000X
0000B0XXX
XXX0F0XXX
XXX000XXX
XXXXXXXXX