NNNNNNNNN
NXX00000N
N0001110N
N011BP10N
N0101000N
N0F1BF10N
N01B0110N
N011F110N
N0000000N
NNNNNNNNN