NNNNNNNNN2
NX00000XN2
N00P1100N2
N0110110N2
N01BLB10N2
N011F110N2
N001F100N2
NX00000XN2
NNNNNNNNN2
2222222222