NNNNNNNNN
NXX00000N
N0001110N
N0111BP0N
N0FFFB00N
N0101B10N
N0111110N
N0000000N
NNNNNNNNN