NNNNNNNNN2
NX00000XN2
N0011110N2
N011B110N2
N010LFF0N2
N0P1B110N2
N0011100N2
NX00000XN2
NNNNNNNNN2
2222222222