NNNNNNNNN2
NX00000XN2
NX0P1F0XN2
N00B0B00N2
N0111110N2
N0100110N2
N0FF1B10N2
N0011110N2
NX000000N2
NNNNNNNNN2