X00000XX
00F11000
01101BP0
01101010
01B11BF0
01111000
000000XX