2NNNNNNNN2
2NX00000N2
2N001BF0N2
2N011BP0N2
2N011B00N2
2N01F110N2
2N01F010N2
2N001110N2
2NX00000N2
2NNNNNNNN2