X000000X
00111100
01FF1110
0101BBB0
01110PF0
00000000