2NNNNNNNN2
2NX00000N2
2N001110N2
2N01F110N2
2N010B00N2
2N0FBPF0N2
2N01B010N2
2N011110N2
2N000000N2
2NNNNNNNN2