2NNNNNNNN2
2NX00000N2
2N001110N2
2N01B010N2
2N0L11B0N2
2N0P1110N2
2N0FB110N2
2N000000N2
2NNNNNNNN2
2222222222