NNNNNNNNN
NXXX0000N
NXX001F0N
NX00PB10N
N001B0F0N
N0111110N
N011BF10N
N0000000N
NNNNNNNNN
