NNNNNNNNN
NX000000N
N001F110N
N01BF010N
N01BF110N
N01B1110N
N0P10110N
N0000000N
NNNNNNNNN