NNNNNNNN
N000000N
N0F1110N
N01B0F0N
N0PB110N
N01BF10N
N000000N
NNNNNNNN